key	text	tooltip
#Loc;1;text/db/hkrul_hakka.loc		
character_skills_localised_name_innate_hkrul_hakka	Brazen Armoured Beserker	true
character_skills_localised_description_innate_hkrul_hakka	The Brazen Armoured Beserker is Tribal Chieftain of the Aesling and devote follower of the God of Slaughter.	true
character_skills_localised_description_hkrul_hakka_special_0_1	Driven by his devotion to Khorne, Hakka seeks to claim the skulls of his fallen foes as trophies of war. This skill grants bonuses to Hakka's leadership and combat effectiveness for each enemy unit he slays in battle.	true
character_skills_localised_name_hkrul_hakka_special_0_1	Throne Abiders	true
character_skills_localised_description_hkrul_hakka_special_1_1	Hakka commands the beasts of the Northern Wastes, bending them to his will and unleashing them upon his enemies. This skill allows for the recruitment of powerful monstrous units unique to the Aesling tribe	true
character_skills_localised_name_hkrul_hakka_special_1_1	Mutated Kin	true
character_skills_localised_description_hkrul_hakka_special_1_2	Hakka is tormented by visions placing him amidst slaughter and battle on what appears to be holy ground among those who worship Chaos..	true
character_skills_localised_name_hkrul_hakka_special_1_2	Fragments of the Altar	true
character_skills_localised_description_hkrul_hakka_special_1_5	As the undisputed leader of the Aesling, Hakka exerts his influence over neighboring tribes and factions, forging alliances or demanding tribute. This skill improves diplomatic relations and increases income from vassals and tributaries.	true
character_skills_localised_name_hkrul_hakka_special_1_5	Hakka's Horn	true
character_skills_localised_description_hkrul_hakka_special_1_0	With a keen eye for plunder and strategic acumen, Hakka leads devastating raiding expeditions into enemy territory. This skill increases the effectiveness of raiding and pillaging actions, yielding greater spoils for the Aesling tribe.	true
character_skills_localised_name_hkrul_hakka_special_1_0	Aesling Marauders	true
character_skills_localised_description_hkrul_hakka_special_1_3	in battle, Hakka channels the unbridled rage of Khorne, becoming a whirlwind of destruction on the battlefiel	true
character_skills_localised_name_hkrul_hakka_special_1_3	Trophy Collector	true
character_skills_localised_description_hkrul_hakka_special_0_2	Hakka fosters unity and cohesion within his tribe, ensuring that his warriors fight as one formidable force. This skill improves army replenishment rate and reduces attrition effects on Aesling armies.	true
character_skills_localised_name_hkrul_hakka_special_0_2	The Aesling Tribe	true
character_skills_localised_description_hkrul_hakka_special_1_4	Hakka's indomitable will and unwavering determination make him a formidable foe on the battlefield. This skill grants Hakka increased resistance to enemy debuffs and crowd control effects.	true
character_skills_localised_name_hkrul_hakka_special_1_4	Skull Gatherer	true
agent_subtypes_onscreen_name_override_hkrul_hakka	Legendary Lord	false
agent_subtypes_description_text_override_hkrul_hakka		false
effects_description_hkrul_hakka_axe	Ability: "Bloodreavers''	true
character_trait_levels_onscreen_name_hkrul_defeated_trait_hakka	Hakkad and Sliced	true
character_trait_levels_colour_text_hkrul_defeated_trait_hakka	It seems somebodies hack'n slashing days are numbered..	true
character_trait_levels_explanation_text_hkrul_defeated_trait_hakka	Defeated Hakka the Aesling	true
ancillaries_colour_text_hkrul_hakka_axe	Forged amidst the frigid chaos of Norsca, the Bloodreavers, twin axes once grasped by Hakka the Aesling, bear the malevolent runes of Khorne's favor. These savage blades, steeped in the lore of northern storms, anticipate the fury of a yet-unfought battle on Zanbaijin's ancient grounds. As Hakka's grim shadow looms, the Bloodreavers thirst for the blood of future adversaries, becoming the embodiment of the Aesling warlord's unrestrained might and the impending tempest that shall echo through the annals of Chaos.	true
ancillaries_onscreen_name_hkrul_hakka_axe	Bloodreavers	true
land_units_onscreen_name_hkrul_hakka	Hakka the Aesling	true
names_name_2570700350	the Aesling	false
names_name_2570700351	Hakka	false
unit_description_short_texts_text_hkrul_hakka	A frenzied berserker by reputation, many foes fall to the whirlwind fury of Hakka's twin battle-axes, their skulls made to garland the Throne of Khorne.	false
unit_abilities_tooltip_text_hkrul_hakka_axe	Hakka wields his twin battle-axes with deadly precision, cleaving through armor and flesh alike.	true
unit_abilities_onscreen_name_hkrul_hakka_axe	Bloodreavers	true
unit_description_historical_texts_text_hkrul_hakka	Hakka the Aesling, Warrior King of the Aesling tribe, faces a dire threat in Throgg the Troll King and his monstrous horde. Determined to usurp the Aesling tribe, Throgg's vile ambitions plunge the Northern Wastes into chaos. Hakka, wielding his twin battle-axes, leads his warriors to confront this monstrous menace, knowing that the fate of his tribe hangs in the balance. As the clash of steel and roar of beasts echo across the frozen landscape, Hakka stands resolute, ready to unleash the fury of Khorne upon the encroaching darkness and preserve the honor of his tribe.	false
character_skill_node_sets_enc_title_skill_node_set_hkrul_hakka	Legendary Lord	false
effects_description_hkrul_hakka_gaze	Ability: "Khorne's Gaze"	true
unit_abilities_tooltip_text_hkrul_hakka_gaze	As defeat draws near Khorne's wrathful gaze invigorates the Aesling to unravel into a ravaging fury.	true
unit_abilities_onscreen_name_hkrul_hakka_gaze	Khorne's Gaze	true
effects_description_hkrul_hakka_berserker_speed	Speed: %+n% for Marauder Berserker units	true
effects_description_rhox_aesling_khorne_dedicated_dummy	Dedicated to Khorne: May only devote himself to Khorne	false
effects_description_rhox_aesling_skull_feature_dummy	Can send a tribute of [[img:icon_skulls]][[/img]]Skulls to the Blood God	false
effect_bundles_localised_description_hkrul_hakka_faction_trait	Aesling marauders willingly dedicate themselves to their own true lord, the God of Slaughter, carnage incarnate - Khorne.	false
effect_bundles_localised_title_hkrul_hakka_faction_trait	The Devoted Aesling	false
effects_description_rhox_aesling_armies_will_spawn_dummy	{{tr:khorne_spawned_armies}} will be spawned upon razing settlements for the Hound	false
land_units_onscreen_name_scm_fc_norsca_aesling_nor_marauder_spear	Aesling Spearmen	false
land_units_onscreen_name_scm_fc_norsca_aesling_nor_marauder	Aesling Marauders	false
land_units_onscreen_name_scm_fc_norsca_aesling_nor_marauder_great_weapons	Aesling Marauders (Great Weapons)	false
land_units_onscreen_name_scm_fc_norsca_aesling_nor_marauder_horsemen_throwing_axe	Aesling Marauder Horsemen (Throwing Axes)	false
land_units_onscreen_name_scm_fc_norsca_aesling_nor_marauder_throwing_axe	Aesling Hunters (Throwing Axes)	false
land_units_onscreen_name_scm_fc_norsca_aesling_nor_marauder_javelins	Aesling Hunters (Javelins)	false
character_skills_localised_description_hkrul_hakka_chariot	Marauder mobs are awarded even greater mobility when riding their crude chariots of bone and wood, lashed together with the guts and sinew of the vanquished.	false
character_skills_localised_name_hkrul_hakka_chariot	Marauder Chariot	false
character_skills_localised_description_hkrul_hakka_juggernaut	Mighty beasts of groaning iron and brass, taller than a man and possessed of a crushing mass.	false
character_skills_localised_name_hkrul_hakka_juggernaut	Juggernaut	false
units_custom_battle_mounts_localised_description_hkrul_hakkahkrul_hakka_chariot	Marauder mobs are awarded even greater mobility when riding their crude chariots of bone and wood, lashed together with the guts and sinew of the vanquished.	false
units_custom_battle_mounts_mount_name_hkrul_hakkahkrul_hakka_chariot	Marauder Chariot	false
units_custom_battle_mounts_localised_description_hkrul_hakkahkrul_hakka_juggernaut	Mighty beasts of groaning iron and brass, taller than a man and possessed of a crushing mass.	false
units_custom_battle_mounts_mount_name_hkrul_hakkahkrul_hakka_juggernaut	Juggernaut	false
ancillaries_colour_text_hkrul_hakka_chariot	Marauder mobs are awarded even greater mobility when riding their crude chariots of bone and wood, lashed together with the guts and sinew of the vanquished.	false
ancillaries_onscreen_name_hkrul_hakka_chariot	Marauder Chariot	false
ancillaries_colour_text_hkrul_hakka_juggernaut	Mighty beasts of groaning iron and brass, taller than a man and possessed of a crushing mass.	false
ancillaries_onscreen_name_hkrul_hakka_juggernaut	Juggernaut	false
character_skill_level_details_localised_description_1hkrul_hakka_chariot	Marauder mobs are awarded even greater mobility when riding their crude chariots of bone and wood, lashed together with the guts and sinew of the vanquished.	false
character_skill_level_details_localised_name_1hkrul_hakka_chariot	Marauder Chariot	false
character_skill_level_details_localised_description_1hkrul_hakka_juggernaut	Mighty beasts of groaning iron and brass, taller than a man and possessed of a crushing mass.	false
character_skill_level_details_localised_name_1hkrul_hakka_juggernaut	Juggernaut	false
land_units_onscreen_name_hkrul_hakka_chariot	Hakka the Aesling	false
land_units_onscreen_name_hkrul_hakka_juggernaut	Hakka the Aesling	false
ui_text_replacements_localised_text_corruption_effect_prefix_khorne_rhox_aesling	[[col:green]]	false
culture_settlement_occupation_options_tooltip_957887881	Colonise||For the glory of Khorne! Settle your troops. Your settlement will start with a tier 2 settlement building	false
effects_description_rhox_aesling_colonise_feature_dummy	Colonizing settlements requires skulls, which in turn start as tier 2 settlements	false
campaign_payload_ui_details_description_rhox_fc_norsca_bloodfather	Alfkael the Bloodfather will join you	false
missions_localised_title_rhox_fc_norsca_bloodfather	Alfkael the Bloodfather will join you	false
missions_localised_description_rhox_fc_norsca_bloodfather	Alfkael the Bloodfather will join you	false
